#
# 0 D room1.txt 1 key1
# 1 D room1.txt 0
#
# k key1
#
WWWWWWWWWW
W    G   W
W        W
W  m  k  W
W T      W
W      W W
W      WhW
W   WWWW W
0   W    W
WWWWW1WWWW