#
# 0 D room1.txt 2
#
WWWW0WWWWW
W        W
W  S     W
WWWWW    W
W s W    W
W   W  WWW
W     E  W
W        W
W        W
WWWWWWWWWW
