#
# 0 D room2.txt 1
# 1 D room2.txt 0 key1
# 2 E room0.txt 0
#
# k key2
#
WWWW0WWWWW
W S      W
W        W
W   T    W
W        W
W      WWW
W  P   WkW
W      WhW
W      W 1
WWWW2WWWWW
